1111111111
0010110101
1010000001
1000110100
1111111111